111111111111
100000000001
100000000001
10000PCE0001         
100000000001
100000000001
111111111111
